44 0 0 0 44 0 0 44 0 0 0 0 0 0 0 0 44 0 0 0
44 0 0 44 0 0 0 0 0 0 44 0 0 0 0 0 0 0 44 0
44 0 0 47 47 47 47 47 47 47 47 47 47 47 47 47 47 47 47 47 47 47 47 47 47
44 0 0 26 19 19 19 19 19 19 19 19 19 19 19 19 19 19 19 19
44 0 0 25 18 23 23 23 23 23 23 23 23 23 23 23 23 23 23 23
44 0 0 25 21 0 46 0 0 0 0 0 0 0 0 0 0 0 0 0
44 0 0 25 21 0 45 0 0 0 0 0 0 0 0 43 36 36 36 36
44 0 0 25 21 0 0 0 0 0 0 0 0 0 0 42 27 32 32 32
44 0 0 25 21 0 0 0 0 0 0 46 0 0 0 42 30 9 9 9
44 0 0 25 21 0 0 44 44 0 0 45 0 0 0 42 30 9 9 9
44 0 0 25 21 0 0 0 44 0 0 0 0 0 0 42 27 28 28 28
44 0 0 25 21 0 0 0 0 46 0 0 0 0 0 41 40 40 40 40
44 0 0 25 21 0 0 0 0 45 0 46 0 0 0 0 0 0 0 0
44 0 0 25 21 0 0 0 0 0 0 45 0 0 0 0 0 44 44 44
44 0 0 25 21 0 0 0 0 0 0 0 0 0 0 0 44 44 44 44