24 24 24 24 13 12 24 24 24 0 0 0 0 0 0 0 22 17 5 5
24 0 0 0 13 12 0 0 0 0 0 0 0 0 0 0 22 17 5 5
24 0 0 0 13 12 0 0 0 0 0 0 0 0 0 0 22 17 5 5
24 0 0 0 13 12 0 0 0 0 0 0 0 0 0 0 22 15 16 16
24 0 0 0 13 12 0 0 0 0 0 0 0 0 0 0 22 23 23 23
24 0 0 0 13 12 0 0 0 0 0 0 0 0 0 0 0 0 0 0
24 0 0 0 13 12 0 0 0 0 0 0 0 0 0 0 0 0 0 0
24 0 0 0 13 12 0 0 0 0 0 0 0 0 0 0 0 0 0 0
24 0 0 0 13 12 0 0 0 0 0 0 0 0 0 0 0 0 0 0
24 0 0 0 13 12 0 0 0 0 0 0 0 0 0 0 0 0 0 0
24 0 0 0 13 12 0 0 0 0 0 0 0 0 0 0 0 0 0 0
24 0 0 0 13 12 0 0 25 25 25 25 25 25 25 25 25 25 25 25
24 0 0 0 13 12 0 0 24 24 24 24 24 24 24 24 24 24 24 24
24 0 0 0 13 12 0 0 24 24 24 24 24 24 24 24 24 24 24 24
24 24 24 24 13 12 24 24 24 24 24 24 24 24 24 24 24 24 24 24